# Copyright 2021 The ChromiumOS Authors
# Use of this source code is governed by a BSD-style license that can be
# found in the LICENSE file.

# Valid device-tree compatible string prefixes used in this
# Zephyr module.  The format is:
#  vendor-prefix<TAB>vendor name
cros-ec	The Chromium OS Embedded Controller Project
cros	The Chromium OS Embedded Controller Project
intersil	Intersil
lgc	LG Chem
smp	Battery vendor
aec	Battery vendor
powertech	Battery vendor
getac	Battery vendor
ganfeng	Battery vendor
byd	Battery vendor
celxpert	Battery vendor
sunwoda	Battery vendor
cosmx	Battery vendor
dynapack	Battery vendor
atl	Battery vendor